NO ./TEXTURES/texture_NO.xpm
SO ./TEXTURES/texture_SO.xpm
EA ./TEXTURES/texture_EA.xpm
WE ./TEXTURES/texture_WE.xpm

F 100,100,100
C 200,200,255

11111111111
10000000001
10000000001
10000W00001
100000000011111111111
100000000000000000001
111111111111111111111

