NO ./TEXTURES/texture_NO.xpm
SO ./TEXTURES/texture_SO.xpm
EA ./TEXTURES/texture_EA.xpm
WE ./TEXTURES/texture_WE.xpm

F 0,0,0
C 0,0,0

11111111111
10000000001
10101010101
10000000001
101010101011111111111
1000000000000000000S1
100000001011111111111
D00000000011111111111
100000000000000000001
100000000011111111111
11111D11111





10000001
1111111111111111
11000001111111111111
11111111111111111111
