1111111111
1000000001
1P000000E1
1CCCCCCCC1
1111111111
