11111111111111111111
10001000000000000E01
10101000000000000001
10101000000000000001
1C101000000000000001
10101011111111111111
1P100000000000000001
11111111111111111111
