111111111111111111111111111111111111111111111111111
100C0N00C0N00C0N00C0N0110N0000N0000N0000N0000N00001
100000000000000000000011000000000000000000000000001
100000000000000000000011000000000000000000000000001
1000000000000000000000000000000000000000000000000E1
100000000000000000000011000000000000000000000000001
1P0C0000C0000C0000C00011000000000000000000000000001
111111111111111111111111111111111111111111111111111
